###################
#.................#
#.#.#.#.#.#.#.#.#.#
#.................#
#.#.#.#.#.#.#.#.#.#
#.....#...........#
#.#.#.#.###.#.#.#.#
#.................#
#.#.#.#.#.#.#.#.#.#
#.................#
###################